11111111111111111
11111111111111111
100P00000000000C1
10101111000000001
1C00000000C0000E1
11110000000111111
11111111111111111
