111111111111111111111
111111111111111111111
1P000000000000C0000C1
101011011110100001101
101011000001110001101
10000000000000C101101
101011000000001001101
1010110000C0000001101
1C0000C000100C00000E1
111111111111111111111
