1111111111
1111111111
1P000000C1
1010111111
1C0000CEC1
1111111111
