111111111111111111111
111111111111111111111
100000000000000000001
1000000C0000000000001
1P0000010000C11110001
100000110000100001001
100001010000000010001
100C10010000000100001
10C100010C00001000001
101111111100010000001
10000001000010000C001
100000010000111111001
1000000000000000000E1
111111111111111111111
