111111111111111111111
10000000000000000C001
10000C00000C000011101
10000110C001100000001
100000011110000000C01
10000000C0E0000011111
100P0C0011000C0000001
10C01100C000110000001
111111111111111111111
