111111111111111111111
1P000000000000C0000C1
101011000000000001101
101011000001110001101
10101100000000C101101
101011000000000001101
1010110000C0000001101
1C0000C000000C00000E1
111111111111111111111
