111111111111111111111
1P000000000000000C001
10000C00000C000011101
10000110C001100000001
100000011110000000C01
100000000C00000011111
10000C0011000C0000001
10C01100C0001100000E1
111111111111111111111
