1111111111
1PE00000C1
1010111101
1C0000C0E1
1111111111
