1111111111
1P000000C1
1111011111
1C100000E1
1111111111
