1111111111
10000E00C1
1111011101
1C1001P101
1111111111
