1111111111
1P00000001
1010111101
10000000E1
1111111111
