1111111111
1P000000C1
          
