1111111111
10000000C1
1111011101
1C1001P0E1
1111111111
