1111111111
1E000000C1
1010111101
1C0000C001
1111111111
