1111111111
1P000000C1
1010111101
1C0000C0P1
1111111111
